{
    "width": 35,
    "height": 14,
    "spawn": { "x": 3, "y": 7 },
    "zoneName": "TOWN",
    "tiles": [
        14,14,14,14,14,14,14,14,14,14,14,14,14,14,14,14,14,14,14,14,14,14,14,14,14,14,14,14,14,14,14,14,14,14,14,
        14,14,15,14,14,14,14,15,14,14,14,14,14,14,14,14,14,14,15,14,14,14,14,14,14,14,14,14,14,14,14,14,14,14,14,
        11,11,11,11,11,11,11,11,11,18,11,11,11,11,11,11,11,11,11,11,18,11,11,11,11,11,11,11,11,11,11,11,11,11,11,
        13,13,11,13,20,12,12,12,12,12,12,12,12,12,12,12,12,12,12,12,12,12,12,12,12,12,12,12,13,13,11,13,13,13,13,
        13,13,11,13,13,12,12,12,12,12,12,12,12,19,19,12,12,12,12,12,12,12,12,12,12,12,12,12,13,13,11,13,13,13,13,
        13,13,11,13,13,12,12,12,12,12,12,12,12,12,12,12,12,12,12,19,19,12,12,12,12,12,12,12,13,13,11,13,13,13,13,
        21,11,11,11,11,12,12,12,12,12,12,12,12,12,12,12,12,12,12,12,12,12,12,12,12,12,12,12,11,11,11,11,11,16,11,
        11,11,11,11,11,12,12,12,12,12,12,12,12,12,12,12,12,12,12,12,12,12,12,12,12,12,12,12,11,11,11,11,11,11,11,
        21,11,11,11,11,12,12,12,12,12,12,12,12,12,12,12,12,12,12,12,12,12,12,12,12,12,12,12,11,11,11,11,11,11,11,
        13,13,11,13,13,12,12,12,12,12,12,12,12,12,12,12,12,19,19,12,12,12,12,12,12,12,12,12,13,13,11,13,13,13,13,
        13,13,11,13,13,12,12,12,12,12,12,12,12,12,12,12,12,12,12,12,12,12,12,12,12,12,12,12,13,13,11,13,20,13,13,
        11,11,11,11,11,11,11,11,11,11,11,11,11,18,11,11,11,11,11,11,11,11,18,11,11,11,11,11,11,11,11,11,11,11,11,
        14,14,14,14,14,14,14,14,14,14,14,14,14,14,14,15,14,14,14,14,14,14,14,14,14,14,14,14,14,14,14,14,14,14,14,
        14,14,14,14,14,14,14,14,14,14,14,14,14,14,14,14,14,14,14,14,14,14,14,14,14,14,14,14,14,14,14,14,14,14,14
    ],
    "enemies": [],
    "items": [
        { "type": "rock", "x": 4, "y": 7 },
        { "type": "rock", "x": 4, "y": 7 },
        { "type": "bandage", "x": 10, "y": 7 },
        { "type": "soap", "x": 16, "y": 7 },
        { "type": "rock", "x": 22, "y": 7 },
        { "type": "rock", "x": 22, "y": 7 },
        { "type": "bandage", "x": 28, "y": 7 }
    ],
    "transitions": [
        { "x": 33, "y": 6, "toMap": "sewer-map.json", "toX": 1, "toY": 10, "label": "[Descend into the sewer]" }
    ]
}
